11
1111111111112000000001101110111111000100000111111111101100000001011111111010110000010001101110111011000100000311111111114

11111111111
12000000001
10111011111
10001000001
11111111101
10000000101
11111110101
10000010001
10111011101
10001000003
11111111114

███████████
          █
█ ███ █████
█   █     █
█████████ █
█       █ █
███████ █ █
█     █   █
█ ███ ███ █
█   █      
███████████